ASE = "countries/Austrian Empire.txt"
RSE = "countries/Russia Empire.txt"
RME = "countries/Russian Middle East.txt"
NRK = "countries/Norway Kingdome.txt"
DNK = "countries/Danian Kingdome.txt"
GME = "countries/German Empire.txt"
SWK = "countries/Sweden Kingdome.txt"
SRK = "countries/Serbia.txt"
NJD = "countries/Nejd.txt"
KAL = "countries/ALBANIA.txt"
EPA = "countries/Ephiopia.txt"
SPA = "countries/Ispania.txt"
AFN = "countries/Afghanistan.txt"
PRT = "countries/Portugal.txt"
BPZ = "countries/British Persian Zaliv.txt"
ITL = "countries/Italy.txt"
OMN = "countries/Oman.txt"
FTP = "countries/French Tunnis.txt"
FTM = "countries/French Marocco.txt"
FRR = "countries/French Republic.txt"
RMK = "countries/Romania.txt"
SSA = "countries/South Africa.txt"
BLT = "countries/Bulgaria.txt"
GRK = "countries/Greece.txt"
OTM = "countries/Ottoman.txt"
NTL	= "countries/Netherlands.txt"
BGL = "countries/Belgium.txt"
BRT = "countries/Britain.txt"
MOT = "countries/Chernogoria.txt"
PRS = "countries/Persia.txt"
BIN = "countries/British India.txt"
HDB = "countries/Hyderabad.txt"
BAS = "countries/British Australia.txt"
BNZ = "countries/New Zeeland.txt"
SMK = "countries/Siam.txt"


